=== MAP ===
-- ZONE 1 --
0 0 0 14 3 5 0 0 4 16
-1 0 -1 0 0 0 0 5 0 12
0 0 0 0 0 0 0 0 0 0
0 0 0 0 0 -1 0 0 0 0
0 0 -2 0 4 3 -1 13 0 0
0 14 0 0 2 0 0 0 0 0
0 0 0 12 0 5 16 0 0 0
0 15 0 0 0 16 0 0 3 0
0 0 0 1 -1 4 0 -1 0 0
0 0 0 -1 0 0 0 0 0 14
-- ZONE 2 --
0 0 0 0 18 6 0 0 0 0
0 0 0 0 0 0 0 0 0 0
0 0 0 0 8 0 6 0 0 -1
0 0 0 19 0 7 0 0 0 -1
0 0 20 0 20 0 0 7 0 0
18 21 0 -3 -2 0 0 0 0 8
21 21 0 0 -1 0 0 0 0 17
0 0 0 0 0 0 0 0 -1 0
0 0 0 0 -1 -1 -1 0 8 7
0 19 0 6 0 0 0 2 0 0
-- ZONE 3 --
22 -1 22 11 9 0 0 0 0 0
0 10 0 0 0 0 0 9 0 0
0 0 0 0 0 0 0 -1 -1 0
0 0 26 22 0 0 0 0 0 99
0 -1 0 0 0 0 0 26 0 0
0 0 0 0 0 23 10 0 0 11
22 9 0 0 0 0 -1 0 11 0
0 0 10 0 25 0 0 0 -1 0
0 0 0 23 0 -1 0 0 24 -3
0 0 0 0 0 0 0 0 2 0
=== PLAYER ===
{1}
{0}/{1000}
{100}/{100}
-- INVENTORY --
{1}@{1}@{10}
{1}@{2}@{10}
{1}@{3}@{10}
{1}@{4}@{10}
{0}@{0}@{0}
{0}@{0}@{0}
{0}@{0}@{0}
{0}@{0}@{0}
{0}@{0}@{0}
{0}@{0}@{0}
-- STORAGE --
{10}@{29}
{1}@{11}