=== MAP ===
-- ZONE 1 --
0 0 0 0 15 13 0 0 0 0
0 14 0 0 -1 0 0 0 0 0
-1 0 0 5 4 5 0 -2 16 -1
1 0 0 0 14 0 0 4 0 0
0 0 0 0 0 0 3 -1 16 0
0 0 0 13 0 2 0 0 0 0
3 0 0 16 0 0 0 -1 0 0
-1 0 0 0 0 0 14 0 0 0
0 0 0 0 5 0 0 0 0 0
3 0 4 0 0 -1 0 0 16 0
-- ZONE 2 --
-1 0 0 17 0 0 18 0 0 -1
0 -3 0 0 0 0 0 0 0 0
0 0 0 -1 0 20 0 0 0 0
6 0 7 0 0 0 0 8 -1 0
0 0 0 0 0 -1 0 8 0 0
0 0 0 0 0 2 0 -1 0 0
0 0 17 0 18 0 8 0 0 18
0 18 0 -1 0 0 21 0 0 7
0 0 0 0 6 0 0 19 0 0
0 0 6 0 0 7 -2 0 19 0
-- ZONE 3 --
-1 0 0 -1 0 0 0 -1 0 0
10 9 0 0 22 -1 0 23 0 0
0 0 0 -3 0 0 2 0 0 0
26 24 9 0 0 0 9 0 0 0
0 0 0 0 10 -1 22 0 0 0
0 0 25 0 0 0 0 11 0 0
0 0 0 0 0 0 26 10 0 0
0 0 -1 0 22 0 0 0 25 0
0 11 0 0 11 0 0 0 99 0
0 0 0 0 -1 0 0 26 0 0
=== PLAYER ===
{1}
{0}/{1000}
{100}/{100}
-- INVENTORY --
{1}@{1}@{10}
{1}@{2}@{10}
{1}@{3}@{10}
{1}@{4}@{10}
{0}@{0}@{0}
{0}@{0}@{0}
{0}@{0}@{0}
{0}@{0}@{0}
{0}@{0}@{0}
{0}@{0}@{0}
-- STORAGE --
