=== MAP ===
-- ZONE 1 --
0 0 0 -1 0 0 13 0 0 0
0 0 -1 0 13 0 0 0 0 0
0 0 1 0 2 0 14 0 0 -1
0 0 0 5 0 0 0 0 0 0
16 0 15 0 -2 0 16 0 0 4
0 12 0 0 0 0 0 0 0 5
0 16 4 -1 0 0 -1 0 0 14
0 0 0 -1 4 0 -1 0 0 0
3 0 0 0 0 0 13 3 0 5
0 0 0 0 0 0 0 3 0 0
-- ZONE 2 --
0 18 0 0 0 0 18 0 7 8
0 0 0 0 0 0 0 0 0 0
0 7 0 0 0 0 0 0 18 0
0 0 0 -3 0 0 0 21 0 0
17 0 0 21 0 0 0 0 -1 -1
0 0 17 -2 -1 0 0 21 -1 7
0 0 20 0 0 0 0 0 19 0
6 0 0 8 0 0 0 0 0 0
-1 6 0 0 0 0 0 0 -1 6
0 0 8 0 -1 0 0 0 2 0
-- ZONE 3 --
0 -1 0 0 0 22 0 -1 23 0
0 0 0 0 0 0 0 0 0 0
0 0 0 10 23 0 0 0 0 25
-1 0 0 0 0 0 23 0 0 0
9 10 0 0 0 24 0 0 0 0
9 0 0 0 -1 99 2 0 25 0
22 23 0 0 0 0 0 -1 -1 0
0 0 0 0 0 0 0 0 0 0
0 11 0 0 0 0 10 0 -1 9
22 0 11 0 0 11 -3 0 0 0
=== PLAYER ===
{1}
{0}/{1000}
{100}/{100}
-- INVENTORY --
{1}@{1}@{10}
{1}@{2}@{10}
{1}@{3}@{10}
{1}@{4}@{10}
{10}@{29}@{0}
{0}@{0}@{0}
{0}@{0}@{0}
{0}@{0}@{0}
{0}@{0}@{0}
{0}@{0}@{0}
-- STORAGE --
