=== MAP ===
-- ZONE 1 --
0 0 1 0 0 0 3 0 14 0
0 0 0 0 0 0 0 0 0 0
0 0 0 0 0 -1 0 14 2 4
0 4 0 16 0 0 0 0 12 0
0 0 0 0 0 0 5 0 -1 0
-1 0 0 5 0 0 0 13 -1 0
0 4 15 0 0 5 12 0 0 0
0 0 0 0 0 0 -2 12 -1 0
0 14 0 0 0 -1 0 0 0 0
0 0 0 0 3 0 0 16 -1 3
-- ZONE 2 --
17 0 -1 0 0 0 0 0 -2 0
0 0 0 0 -3 18 0 0 -1 0
6 0 0 0 0 7 8 0 19 0
0 0 0 0 0 0 0 0 -1 0
0 21 0 0 -1 0 0 0 0 21
20 0 0 0 8 0 2 0 0 0
21 21 -1 0 0 0 0 0 0 6
0 0 0 0 8 6 0 0 0 7
0 0 0 0 0 0 -1 7 0 0
0 20 0 0 18 0 -1 0 0 0
-- ZONE 3 --
0 0 0 10 0 0 0 11 0 22
25 0 22 0 0 25 0 0 0 0
0 0 0 0 0 0 0 0 10 0
0 0 0 0 -1 0 0 -1 0 23
9 -1 24 0 0 0 9 0 11 0
0 2 0 23 0 0 99 24 0 0
0 0 0 0 0 -1 0 0 0 0
-1 0 0 0 0 22 0 0 9 0
0 0 0 0 0 0 -1 0 0 10
24 0 -3 -1 0 11 0 0 0 0
=== PLAYER ===
{1}
{0}/{1000}
{100}/{100}
-- INVENTORY --
{1}@{1}@{10}
{1}@{2}@{10}
{1}@{3}@{10}
{1}@{4}@{10}
{0}@{0}@{0}
{0}@{0}@{0}
{0}@{0}@{0}
{0}@{0}@{0}
{0}@{0}@{0}
{0}@{0}@{0}
-- STORAGE --
