=== MAP ===
-- ZONE 1 --
-1 0 0 0 0 0 0 15 -1 -1
0 0 0 0 0 0 13 0 0 0
0 0 0 0 -1 0 0 0 0 5
13 0 0 0 0 4 2 0 0 0
15 0 0 0 0 15 -2 0 0 0
12 15 0 0 0 0 0 0 0 0
0 16 0 0 0 12 4 0 3 -1
1 5 0 0 0 0 0 0 3 0
0 0 0 0 0 4 0 0 3 0
-1 0 0 0 5 12 -1 0 0 0
-- ZONE 2 --
2 0 0 0 0 -1 6 0 0 0
-1 0 0 -1 7 0 0 6 0 0
0 0 8 0 0 8 0 -3 20 0
6 18 0 0 0 0 0 18 0 21
8 0 0 0 0 0 0 0 0 0
0 0 0 7 18 0 0 0 0 0
0 0 0 7 0 0 0 0 0 0
21 0 21 0 0 0 0 -1 0 0
0 -1 0 0 0 -1 0 21 0 -2
0 0 0 0 0 21 -1 21 0 0
-- ZONE 3 --
0 9 0 0 0 0 0 0 0 0
0 -1 0 23 0 0 0 0 0 -1
0 -1 10 0 0 0 23 0 0 0
0 0 9 0 22 0 -1 0 0 0
0 0 0 0 0 99 11 10 0 0
0 0 9 -1 0 11 0 0 24 10
0 0 0 0 0 0 0 22 23 0
0 0 0 0 0 0 0 0 0 0
11 0 -3 0 0 24 0 23 0 24
0 0 -1 26 -1 0 0 0 2 0
=== PLAYER ===
{1}
{0}/{1000}
{100}/{100}
-- INVENTORY --
{1}@{1}@{10}
{1}@{2}@{10}
{1}@{3}@{10}
{1}@{4}@{10}
{0}@{0}@{0}
{0}@{0}@{0}
{0}@{0}@{0}
{0}@{0}@{0}
{0}@{0}@{0}
{0}@{0}@{0}
-- STORAGE --
